Oleksandr_Hele1	777
ghghjgfj	gjjffjf
gjfkfkf	fjfkdk
Oleksandr_Hele1	jgkgkf77
Volodymyr	vova2900
fjkdkd	12627
gfjjffj	rjeje
fjfjdjd	fjdjsks
fkfkkd	fjdkdkd
fjfkjdk	fkdksjsnaaa
fjfjdjssjsjs	fjdjkdjdjdjdjfjg
ffjdjsjsjs	18922
fjfkdkdsd	dujdjdjdj
gjfjfjfnfnf	nfjfjfjgg
fffmdkdkdsks	fjjdkdkdkdk
ghfjfjfjd	gfjfjfjff
vjfjff777	891
gkgkfkf	gfkfkff
jgjjffd	fjffddj
jgjfjffj	fjdjsjsjsd
jgjffjfj	fjfkfjfj
gfjfjfjfjf	fjfjjfjdjd
fjfjfjf	gjfjfjfkf
jgjfjfjf	gjfkfkkff
hfjffjjf	jfjfjfjf
gjfjfjffj	fjfjdjdjd
fjfkfjfjf	fhfdjdjdjd
fjfjfjfjf	fjjfjjff
fjfjfjfjfjfjf	fnfjfjfjfjf
fjjfjffjfjfjfj	jfjfjfjffjf
gjfjfjfjf	fhjjffjjfjf
gjfkfjf	fjfjfjfj
ghfhfhhf	fjfjfjfjfj
jfjffjf	jffjfjfjf
hfjfjfjfj	fjfjfjfjf
gjgjgj	jjfjf
fjfjfjfj	jffjf
jffjjff	fkfkfkf
vova	vova
vova2000	vova2
vova890	vova12
TestDep	DEP
ffkfkf	dhjdjdjd
fififjf	fjfjdjj
fjfjfkjdkjd	jdjdjdjd
fkfkgjgjg	gjfjfkf21
gkfkfkfk	fjgkgjgg
fkfkjfjfjd	nfjddjjdjd
fjfjgjgjg	djsjsjdjfjgk
fkfkfkf	jfjfjdjss
fjfjfjgjg	fjfjjffjf
jfjfjfjfjf	jfjfjfjgkdks
gjkjfkfkf	gmfkfkfkfk
ffkfkfkfk	fkfkdkss
ffkfkfkdkd	ffjdksksk
fjfkjdjsj	fjdjsjsj
gmfjdjsns	gnfjdjksk
fjfjfdjdf	fhhfddjdj
gkfkdjsjs	gjfjfjfjfj
gjfjfjff	fjfjjss
fkfjkkgkg	fkjdkdkdk
jfjfjfjf	ghfjfj
gjgjfjfj	ghfjfjfj
1	gjfjfjdjsjsf
fjfjfjsjsjs	gjfkfkdkd
gkfkfkf	gjfjfjfj
gjfkjfkfk	fjdjdsjdsj
fjfkfkfk	fjfjfjfjgjgjd
gjfjdjdjfj	gjfjgjghgddkfkg
gjfjkfjfjgjg	fjfjfjfhftbtvkdld
gjgfjfjfjf	gkgkgkgtdtdtgbs
gkgkfgjfkf	ggjghgttsdusdk
gjfkfkfkfkfkf	gjgjgjgytdtrsghs
gkjfgkfkf	jgjgjghftdydjd
ggjfjdjdgd	gjfjfjfjfjbg
gjgkgkfkf	gjgjfjkfj
fhfjfjfj	gjgjgfjfgjgj
gjkfkfkfk	gjgkgkfkjdgdyf
gjfjfjfj	gjgkgkfldkdkd
fkfkfkgkg	gjgjfjfjfj
